R 500 500

NO ./textures/bluestone.xpm
SO ./textures/south.xpm
WE ./textures/west.xpm
EA ./textures/east.xpm

S ./textures/jewel.xpm

F 128,128,123
C 80,188,10

        1111111111111111111111111
        1000000000110000000000001
        1011000001110000002000001
        1001002000000000002000001
111111111011000001110000000001101
100000000011000001110111110011111
11110111111111011100000010001
11110111111111011101010000001
11000000110101011100000010011111
10002000000000001100020010N01111
10000000002000001101010010021111
11000001110101011111011112001111
11110111 1110101 101111010001111
11111111 1111111 111111111111111
